#####........................
#...#........................
#...#........................
#...#........................
#...#####.........###########
#.......#.........#.........#
#.......#.........#.........#
#.......#.........#.........#
#.......#.........#.....#####
#.......#.........#.....#....
###########.......#.....#....
........#.#.......#.....#....
..^##########.###########....
........#.#.#.#...#..........
........###########..........
..........#.#.#..............
........###########..........
........#.#.#.#...#..........
......###########.#..........
......#.#.#.#.#.#.#..........
###########.#.#.#.#..........
#.....#.#...#.#.#.#..........
#.....#######.#####..........
#.......#.......#............
#.......#.......#............
........#.......#............
........###########..........
................#.#..........
................#####........
..................#.#........
..................#.#........
..................#.#........
..........#####...#.#........
..........#...#...#.#........
..........#...#...#.#........
..........#...#...#.#........
..........#...#####.#........
..........#.........#........
..........###########........

R,10,R,10,R,6,R,4,R,10,R,10,L,4,R,10,R,10,R,6,R,4,R,4,L,4,L,10,L,10,R,10,R,10,R,6,R,4,R,10,R,10,L,4,R,4,L,4,L,10,L,10,R,10,R,10,L,4,R,4,L,4,L,10,L,10,R,10,R,10,L,4

R,10,R,10,R,6,R,4
R,10,R,10,L,4
R,4,L,4,L,10,L,10
ABACABCBCB
